9 16
@@@@@@@@E@@@@@@@
@+++++@++++@+++@
@+@@@+@@@@+@+@+@
@@@+@++++++@+@+@
@+++@@+@+@@@@@+@
@@@++++@+@++@++@
@+@@+@@@@@@+@@+@
@++++++++++++++@
@@@@@@@@M@@@@@@@