12 16
@@@@@@@@E@@@@@@@
@+++++@++++@+++@
@+@+@+++@@+@+@+@
@+@+@++++++@+@+@
@++++@+@+@++@@+@
@+@++++@+@++@++@
@++@++@+@+++@@+@
@++++++++++++++@
@+++++@++++@+++@
@+++@+@++@+@+@+@
@@++@++++++@+@+@
@@@@@@@@M@@@@@@@