24 45
@@@@@@@@@@@@@@@@@@@@@@@@@@@@@@@@@@@@@@@@@@@@@
@@@@@@@+@@@@@@@@@@@@@@+@@@@@@@@@@@@@@+@@@@@@@
@@@@@@@+@@@@@@@@@@@@@@+@@@@@@@@@@@@@@+@@@@@@@
@@@@@@@+@@@@@@@@@@@@@@+@@@@@@@@@@@@@@+@@@@@@@
@@@@@@@+@@@@@@@@@@@@@@+@@@@@@@@@@@@@@+@@@@@@@
@@@@@@@+@@@@@@@@@@@@@@+@@@@@@@@@@@@@@+@@@@@@@
@@@@@@@+@@@@@@@@@@@@@@+@@@@@@@@@@@@@@+@@@@@@@
@@@@@@@+@@@@@@@@@@@@@@+@@@@@@@@@@@@@@+@@@@@@@
@@@@@@@+@@@@@@@@@@@@@@+@@@@@@@@@@@@@@+@@@@@@@
@@@@@@@+@@@@@@@@@@@@@@+@@@@@@@@@@@@@@+@@@@@@@
@@@@@@@+@@@@@@@@@@@@@@+@@@@@@@@@@@@@@+@@@@@@@
@@@@@@@+@@@@@@@@@@@@@@+@@@@@@@@@@@@@@+@@@@@@@
@@@@@@@+@@@@@@@@@@@@@@+@@@@@@@@@@@@@@+@@@@@@@
@@@@@@@+@@@@@@@@@@@@@@+@@@@@@@@@@@@@@+@@@@@@@
@@@@@@@+@@@@@@@@@@@@@@+@@@@@@@@@@@@@@+@@@@@@@
@@@@@@@+@@@@@@@@@@@@@@+@@@@@@@@@@@@@@+@@@@@@@
@@@@@@@+@@@@@@@@@@@@@@+@@@@@@@@@@@@@@+@@@@@@@
@@@@@@@+@@@@@@@@@@@@@@+@@@@@@@@@@@@@@+@@@@@@@
@@@@@@@+@@@@@@@@@@@@@@+@@@@@@@@@@@@@@+@@@@@@@
@@@@@@@+@@@@@@@@@@@@@@+@@@@@@@@@@@@@@+@@@@@@@
@@@@@@@+@@@@@@@@@@@@@@+@@@@@@@@@@@@@@+@@@@@@@
@@@@@@@+@@@@@@@@@@@@@@+@@@@@@@@@@@@@@+@@@@@@@
@@@@@@@+@@@@@@@@@@@@@@+@@@@@@@@@@@@@@+@@@@@@@
@@@@@@@M@@@@@@@@@@@@@@@@@@@@@@@@@@@@@@@@@@@@@