8 15
@@@@@@@+@@@@@@@
@+++++@+@+++++@
@@@+@+++@+@+@+@
@+++@@@@++@+@+@
@+@+++++@@@+@@@
@+@@@+@+++@+++@
@+@+++@+@+++@+@
@@@@@@@M@@@@@@@