13 13
@@@@@@E@@@@@@
@+++@+++++++@
@+@+++@@@@@+@
@+@+@+@+++@+@
@+@@@@@@@+++@
@+@+@+++@@@+@
@@@+@+@+@+++@
@+++@@@+++@@@
@+@@@+@+@@@+@
@+@+++@+++@+@
@+@+@+@@@+@+@
@+++@+++++++@
@@@@@@M@@@@@@