8 15
@@@@@@@E@@@@@@@
@+++++++++@+++@
@+@@@@@@@+@+@@@
@++++++@+@@+@+@
@+@+@+++++++@+@
@+@@@+@@@@+@@+@
@+@+++@+++++++@
@@@@@@@M@@@@@@@